11111#                             #11111
11111#                             #11111
11111# l l         |           l l #11111
11111# l l         |           l l #11111
11111#                             #11111
11111#                             #11111
11111# l l     X   |           l l #11111
11111# l l         |           l l #11111
11111#                             #11111
11111#                             #11111
11111# l l         |           l l #11111
11111# l l         |           l l #11111
11111#                             #11111
11111#                             #11111
11111# l l         |           l l #11111
11111# l l         |           l l #11111
11111#                             #11111
11111#                             #11111
11111# l l         |           l l #11111
11111# l l         |           l l #11111
11111#                             #11111
11111#                             #11111
11111# l l         |           l l #11111
11111# l l         |           l l #11111
11111#                             #11111
11111#                             #11111
11111# l l         |           l l #11111
11111# l l         |           l l #11111
11111#                             #11111
11111#                             #11111
11111# l l         |           l l #11111
11111# l l         |           l l #11111
11111#                             #11111
11111#                             #11111
11111# l l         |           l l #11111
11111# l l         |           l l #11111
11111#                             #11111
11111#                             #11111
11111# l l         |           l l #11111
11111# l l         |           l l #11111
11111#                             #11111
11111# l l         |           l l #11111
11111# l l         |           l l #11111
11111#                             #11111
11111#                             #11111
11111# l l         |           l l #11111
11111# l l         |           l l #11111
11111#                             #11111
11111#                             #11111
11111# l l         |           l l #11111
11111# l l         |           l l #11111
11111#                             #11111
11111#                             #11111
11111# l l         |           l l #11111
11111# l l         |           l l #11111
11111#                             #11111
11111#                             #11111
11111# l l         |           l l #11111
11111# l l         |           l l #11111
11111#                             #11111
11111#                             #11111
11111# l l         |           l l #11111
11111# l l         |           l l #11111
11111#                             #11111
11111#                             #11111
11111# l l         |           l l #11111
11111#                             #11111
11111#                             #11111
11111#                             #11111
11111# l l         |           l l #11111
11111# l l         |           l l #11111
11111#                             #11111
11111#                             #11111
11111# l l         |           l l #11111
11111# l l         |           l l #11111
11111#                             #11111
11111#                             #11111
11111# l l         |           l l #11111
11111# l l         |           l l #11111
11111#                             #11111
11111#                             #11111
11111# l l      aa |           l l #11111
11111# l l         |           l l #11111
11111#                             #11111
11111#                             #11111
11111# l l         |           l l #11111
11111# l l         |           l l #11111
11111#                             #11111
11111#                             #11111
11111# l l         |           l l #11111
11111# l l         |           l l #11111
11111#                             #11111
11111#                             #11111
11111# l l         |           l l #11111
11111# l l         |           l l #11111
11111#                             #11111
11111#                             #11111
11111# l l         |           l l #11111
11111# l l         |           l l #11111
11111#                             #11111
11111#                             #11111
11111# l l         |           l l #11111
11111# l l         |           l l #11111
11111#                             #11111
11111#                             #11111
11111# l l         |           l l #11111
11111# l l         |           l l #11111
11111#                             #11111
11111#                             #11111
11111# l l         |           l l #11111
11111# l l         |           l l #11111
11111#                             #11111
11111#                             #11111
11111# l l         |           l l #11111
11111# l l         |           l l #11111
11111#                             #11111
11111#                             #11111
11111# l l         |           l l #11111
11111# l l         |           l l #11111
11111#                             #11111
11111#                             #11111
11111# l l         |           l l #11111
11111# l l         |           l l #11111
11111#                             #11111
11111#                             #11111
11111# l l         |           l l #11111
11111# l l         |           l l #11111
11111#                             #11111
11111#                             #11111
11111# l l         |           l l #11111
11111# l l         |           l l #11111
11111#                             #11111
11111#                             #11111
11111# l l         |           l l #11111
11111# l l         |           l l #11111
11111#                             #11111
11111#                             #11111
11111# l l         |           l l #11111
11111# l l         |           l l #11111
11111#                             #11111
11111#                             #11111
11111# l l         |           l l #11111
11111# l l         |           l l #11111
11111#                             #11111
