11111###############################11111
11111#Xl l         |           l l @11111
11111#                             @11111
11111# l l                     l l @11111
11111#                             @11111
11111# l l                     l l @11111
11111#             |               @11111
11111# l l         |           l l @11111
11111#                             @11111
11111# l l                     l l @11111
11111#                             @11111
11111# l l                     l l @11111
11111#                             @11111
11111# l l         |           l l @11111
11111#             |               @11111
11111# l l                     l l @11111
11111#                             @11111
11111# l l                     l l @11111
11111#                             @11111
11111# l l         |           l l @11111
11111#             |               @11111
11111# l l                     l l @11111
11111#                             @11111
11111# l l                     l l @11111
11111#                             @11111
11111# l l         |           l l @11111
11111#             |               @11111
11111# l l                     l l @11111
11111#                             @11111
11111# l l                     l l @11111
11111#                             @11111
11111# l l         |           l l @11111
11111#             |               @11111
11111# l l                     l l @11111
11111#                             @11111
11111# l l                     l l @11111
11111#                             @11111
11111# l l         |           l l @11111
11111#             |               @11111
11111# l l                     l l @11111
11111#                             @11111
11111# l l                     l l @11111
11111#                             @11111
11111# l l         |           l l @11111
11111#             |               @11111
11111# l l                     l l @11111
11111#                             @11111
11111# l l                     l l @11111
11111#                             @11111
11111# l l         |           l l @11111
11111#             |               @11111
11111# l l                     l l @11111
11111#                             @11111
11111# l l                     l l @11111
11111#                             @11111
11111# l l         |           l l @11111
11111#             |               @11111
11111# l l         |           l l @11111
11111#             |               @11111
11111# l l                     l l @11111
11111#                             @11111
11111# l l                     l l @11111
11111#                             @11111
11111# l l         |           l l @11111
11111#             |               @11111
11111# l l         |           l l @11111
11111#             |               @11111
11111# l l                     l l @11111
11111#                             @11111
11111# l l                     l l @11111
11111#                             #11111
11111# l l         |           l l #11111
11111#             |               #11111
11111# l l         |           l l #11111
11111#             |               #11111
11111# l l                     l l #11111
11111#                             #11111
11111# l l                     l l #11111
11111#                             #11111
11111# l l         |           l l #11111
11111#             |               #11111
11111# l l         |           l l #11111
11111#             |               #11111
11111# l l                     l l #11111
11111#                             #11111
11111# l l                     l l #11111
11111#                             #11111
11111# l l         |           l l #11111
11111#             |               #11111
11111# l l         |           l l #11111
11111#             |               #11111
11111# l l                     l l #11111
11111#                             #11111
11111# l l                     l l #11111
11111#                             #11111
11111# l l         |           l l #11111
11111#             |               #11111
11111# l l         |           l l #11111
11111#             |               #11111
11111# l l                     l l #11111
11111#                             #11111
11111# l l                     l l #11111
11111#                             #11111
11111# l l         |           l l #11111
11111#             |               #11111
11111# l l                     l l #11111
11111#             |               #11111
11111#             |               #11111
11111#                             #11111
11111# l l                     l l #11111
11111# l l                     l l #11111
11111# l l                     l l #11111
11111#                             #11111
11111#             |               #11111
11111#             |               #11111
11111#                             #11111
11111# l l                     l l #11111
11111# l l                     l l #11111
11111# l l                     l l #11111
11111#                             #11111
11111#             |               #11111
11111#             |               #11111
11111#                             #11111
11111# l l                     l l #11111
11111# l l                     l l #11111
11111# l l                     l l #11111
11111#                             #11111
11111#             |               #11111
11111#             |               #11111
11111#                             #11111
11111# l l                     l l #11111
11111# l l                     l l #11111
11111# l l                     l l #11111
11111#             |               #11111
11111#             |               #11111
11111# l l                     l l #11111
11111# l l                     l l #11111
11111# l l                     l l #11111
11111#             |               #11111
11111#             |               #11111
11111# l l                     l l #11111
11111# l l                     l l #11111
11111# l l                     l l #11111
11111#             |               #11111
11111#             |               #11111
11111# l l                     l l #11111
11111# l l                     l l #11111
11111# l l                     l l #11111
11111#             |               #11111
11111#             |               #11111
11111# l l                     l l #11111
11111# l l                     l l #11111
11111# l l                     l l #11111
11111#             |               #11111
11111#             |               #11111
11111# l l                     l l #11111
11111# l l                     l l #11111
11111# l l                     l l #11111
11111#             |               #11111
11111#             |               #11111
11111# l l                     l l #11111
11111# l l                     l l #11111
11111# l l                     l l #11111
11111#             |               #11111
11111#             |               #11111
11111# l l                     l l #11111
11111# l l                     l l #11111
11111# l l                     l l #11111
11111#             |               #11111
11111#             |               #11111
11111# l l                     l l #11111
11111# l l                     l l #11111
11111# l l                     l l #11111
11111#             |               #11111
11111#             |               #11111
11111# l l                     l l #11111
11111# l l                     l l #11111
11111# l l                     l l #11111
11111#             |               #11111
11111#             |               #11111
11111# l l                     l l #11111
11111# l l                     l l #11111
11111# l l                     l l #11111
11111#             |               #11111
11111#             |               #11111
11111# l l                     l l #11111
11111# l l                     l l #11111
11111# l l                     l l #11111
11111#             |               #11111
11111#             |               #11111
11111# l l                     l l #11111
11111# l l                     l l #11111
11111# l l                     l l #11111
11111#             |               #11111
11111#             |               #11111
11111# l l                     l l #11111
11111# l l                     l l #11111
11111# l l                     l l #11111
11111#             |               #11111
11111#             |               #11111
11111# l l                     l l #11111
11111# l l                     l l #11111
11111# l l                     l l #11111
11111#             |               #11111
11111#             |               #11111
11111# l l                     l l #11111
11111# l l                     l l #11111
11111# l l                     l l #11111
11111#             |               #11111
11111#             |               #11111
11111# l l                     l l #11111
11111# l l                     l l #11111
11111# l l                     l l #11111
11111#             |               #11111
11111#             |               #11111
11111# l l                     l l #11111
11111# l l                     l l #11111
11111# l l                     l l #11111
11111#             |               #11111
11111#             |               #11111
11111# l l                     l l #11111
11111# l l                     l l #11111
11111# l l                     l l #11111
11111#             |               #11111
11111#             |               #11111
11111# l l                     l l #11111
11111# l l                     l l #11111
11111# l l                     l l #11111
11111#             |               #11111
11111#             |               #11111
11111# l l                     l l #11111
11111# l l                     l l #11111
11111# l l                     l l #11111
11111#             |               #11111
11111#             |               #11111
11111# l l                     l l #11111
11111# l l                     l l #11111
11111# l l                     l l #11111
11111#             |               #11111
11111#             |               #11111
11111# l l                     l l #11111
11111# l l                     l l #11111
11111# l l                     l l #11111
11111#             |               #11111
11111#             |               #11111
11111# l l                     l l #11111
11111# l l                     l l #11111
11111# l l                     l l #11111
11111#             |               #11111
11111#             |               #11111
11111# l l                     l l #11111
11111# l l                     l l #11111
11111# l l                     l l #11111
11111#             |               #11111
11111#             |               #11111
11111# l l                     l l #11111
11111# l l                     l l #11111
11111# l l                     l l #11111
