11111#zlzzlzzzzzzzz|zzzzzzzzzzlzzlz#11111
11111#                             #11111
11111# l  l        |          l  l #11111
11111# l  l        |          l  l #11111
11111#                             #11111
11111#                             #11111
11111# l  l        |          l  l #11111
11111# l  l        |          l  l #11111
11111#                             #11111
11111#                             #11111
11111# l  l        |          l  l #11111
11111# l  l        |          l  l #11111
11111#                             #11111
11111#                             #11111
11111# l  l   dd   |          l  l #11111
11111# l  l        |          l  l #11111
11111#                             #11111
11111#                             #11111
11111# l  l        |          l  l #11111
11111# l  l        |          l  l #11111
11111#                             #11111
11111#                             #11111
11111# l  l        |          l  l #11111
11111# l  l        |          l  l #11111
11111#                             #11111
11111#                             #11111
11111# l  l   dd   |          l  l #11111
11111# l  l        |          l  l #11111
11111#                             #11111
11111#                             #11111
11111# l  l        |          l  l #11111
11111# l  l        |          l  l #11111
11111#                             #11111
11111#                             #11111
11111# l  l        |          l  l #11111
11111# l  l        |          l  l #11111
11111#                             #11111
11111#                             #11111
11111# l  l        |          l  l #11111
11111# l  l        |          l  l #11111
11111#                             #11111
11111#                             #11111
11111# l  l   dd   |          l  l #11111
11111# l  l        |          l  l #11111
11111#                             #11111
11111#                             #11111
11111# l  l        |          l  l #11111
11111# l  l        |          l  l #11111
11111#                             #11111
11111#                             #11111
11111# l  l        |          l  l #11111
11111# l  l        |          l  l #11111
11111#                             #11111
11111#                             #11111
11111# l  l        |          l  l #11111
11111# l  l        |          l  l #11111
11111#                             #11111
11111#                             #11111
11111# l  l        |          l  l #11111
11111# l  l        |          l  l #11111
11111#                             #11111
11111#                             #11111
11111# l  l        |          l  l #11111
11111# l  l        |          l  l #11111
11111#                             #11111
11111#                             #11111
11111# l  l        |          l  l #11111
11111# l  l        |          l  l #11111
11111#                             #11111
11111#                             #11111
11111# l  l     aa |          l  l #11111
11111# l  l        |          l  l #11111
11111#                             #11111
11111#                             #11111
11111# l  l        |          l  l #11111
11111# l  l        |          l  l #11111
11111#                             #11111
11111#                             #11111
11111# l  l        |          l  l #11111
11111# l  l        |          l  l #11111
11111#                             #11111
11111#                             #11111
11111# l  l        |          l  l #11111
11111# l  l        |          l  l #11111
11111#                             #11111
11111#                             #11111
11111# l  l        |          l  l #11111
11111# l  l        |          l  l #11111
11111#                             #11111
11111#                             #11111
11111# l  l        |          l  l #11111
11111# l  l        |          l  l #11111
11111#                             #11111
11111#                             #11111
11111# l  l        |          l  l #11111
11111# l  l        |          l  l #11111
11111#                             #11111
11111#                             #11111
11111# l  l        |          l  l #11111
11111# l  l        |          l  l #11111
11111#                             #11111
11111#                             #11111
11111# l  l        |          l  l #11111
11111# l  l        |          l  l #11111
11111#                             #11111
11111#                             #11111
11111# l  l        |          l  l #11111
11111# l  l        |          l  l #11111
11111#                             #11111
11111#                             #11111
11111# l  l        |          l  l #11111
11111# l  l        |          l  l #11111
11111#                             #11111
11111#                             #11111
11111# l  l        |          l  l #11111
11111# l  l        |          l  l #11111
11111#                             #11111
11111#                             #11111
11111# l  l        |          l  l #11111
11111# l  l        |          l  l #11111
11111#                             #11111
11111#                             #11111
11111# l  l        |          l  l #11111
11111# l  l        |          l  l #11111
11111#                             #11111
11111#                             #11111
11111# l  l        |          l  l #11111
11111# l  l        |          l  l #11111
11111#                             #11111
11111#                             #11111
11111# l  l        |          l  l #11111
11111# l  l        |          l  l #11111
11111#                             #11111
