111111111##############################@111111111
111111111#Xl l         |           l l @111111111
111111111#                             @111111111
111111111# l l                     l l @111111111
111111111#                             @111111111
111111111# l l                     l l @111111111
111111111#             |               @111111111
111111111# l l         |           l l @111111111
111111111#                             @111111111
111111111# l l                     l l @111111111
111111111#                             @111111111
111111111# l l                     l l @111111111
111111111#                             @111111111
111111111# l l         |           l l @111111111
111111111#             |               @111111111
111111111# l l                     l l @111111111
111111111#                             @111111111
111111111# l l                     l l @111111111
111111111#                             @111111111
111111111# l l         |           l l @111111111
111111111#             |               @111111111
111111111# l l                     l l @111111111
111111111#                             @111111111
111111111# l l                     l l @111111111
111111111#                             @111111111
111111111# l l         |           l l @111111111
111111111#             |               @111111111
111111111# l l                     l l @111111111
111111111#                             @111111111
111111111# l l                     l l @111111111
111111111#                             @111111111
111111111# l l         |           l l @111111111
111111111#             |               @111111111
111111111# l l                     l l @111111111
111111111#                             @111111111
111111111# l l                     l l @111111111
111111111#                             @111111111
111111111# l l         |           l l @111111111
111111111#             |               @111111111
111111111# l l                     l l @111111111
111111111#                             @111111111
111111111# l l                     l l @111111111
111111111#                             @111111111
111111111# l l         |           l l @111111111
111111111#             |               @111111111
111111111# l l                     l l @111111111
111111111#                             @111111111
111111111# l l                     l l @111111111
111111111#                             @111111111
111111111# l l         |           l l @111111111
111111111#             |               @111111111
111111111# l l                     l l @111111111
111111111#                             @111111111
111111111# l l                     l l @111111111
111111111#                             @111111111
111111111# l l         |           l l @111111111
111111111#             |               @111111111
111111111# l l         |           l l @111111111
111111111#             |               @111111111
111111111# l l                     l l @111111111
111111111#                             @111111111
111111111# l l                     l l @111111111
111111111#                             @111111111
111111111# l l         |           l l @111111111
111111111#             |               @111111111
111111111# l l         |           l l @111111111
111111111#             |               @111111111
111111111# l l                     l l @111111111
111111111#                             @111111111
111111111# l l                     l l @111111111
111111111#                             @111111111
111111111# l l         |           l l @111111111
111111111#             |               @111111111
111111111# l l         |           l l @111111111
111111111#             |               @111111111
111111111# l l                     l l @111111111
111111111#                             @111111111
111111111# l l                     l l @111111111
111111111#                             @111111111
111111111# l l         |           l l @111111111
111111111#             |               @111111111
111111111# l l         |           l l @111111111
111111111#             |               @111111111
111111111# l l                     l l @111111111
111111111#                             @111111111
111111111# l l                     l l @111111111
111111111#                             @111111111
111111111# l l         |           l l @111111111
111111111#             |               @111111111
111111111# l l         |           l l @111111111
111111111#             |               @111111111
111111111# l l                     l l @111111111
111111111#                             @111111111
111111111# l l                     l l @111111111
111111111#                             @111111111
111111111# l l         |           l l @111111111
