11111##############################@111111111
11111#Xl l         |           l l @111111111
11111#                             @111111111
11111# l l                     l l @111111111
11111#                             @111111111
11111# l l                     l l @111111111
11111#             |               @111111111
11111# l l         |           l l @111111111
11111#                             @111111111
11111# l l                     l l @111111111
11111#                             @111111111
11111# l l                     l l @111111111
11111#                             @111111111
11111# l l         |           l l @111111111
11111#             |               @111111111
11111# l l                     l l @111111111
11111#                             @111111111
11111# l l                     l l @111111111
11111#                             @111111111
11111# l l         |           l l @111111111
11111#             |               @111111111
11111# l l                     l l @111111111
11111#                             @111111111
11111# l l                     l l @111111111
11111#                             @111111111
11111# l l         |           l l @111111111
11111#             |               @111111111
11111# l l                     l l @111111111
11111#                             @111111111
11111# l l                     l l @111111111
11111#                             @111111111
11111# l l         |           l l @111111111
11111#             |               @111111111
11111# l l                     l l @111111111
11111#                             @111111111
11111# l l                     l l @111111111
11111#                             @111111111
11111# l l         |           l l @111111111
11111#             |               @111111111
11111# l l                     l l @111111111
11111#                             @111111111
11111# l l                     l l @111111111
11111#                             @111111111
11111# l l         |           l l @111111111
11111#             |               @111111111
11111# l l                     l l @111111111
11111#                             @111111111
11111# l l                     l l @111111111
11111#                             @111111111
11111# l l         |           l l @111111111
11111#             |               @111111111
11111# l l                     l l @111111111
11111#                             @111111111
11111# l l                     l l @111111111
11111#                             @111111111
11111# l l         |           l l @111111111
11111#             |               @111111111
11111# l l         |           l l @111111111
11111#             |               @111111111
11111# l l                     l l @111111111
11111#                             @111111111
11111# l l                     l l @111111111
11111#                             @111111111
11111# l l         |           l l @111111111
11111#             |               @111111111
11111# l l         |           l l @111111111
11111#             |               @111111111
11111# l l                     l l @111111111
11111#                             @111111111
11111# l l                     l l @111111111
11111#                             @111111111
11111# l l         |           l l @111111111
11111#             |               @111111111
11111# l l         |           l l @111111111
11111#             |               @111111111
11111# l l                     l l @111111111
11111#                             @111111111
11111# l l                     l l @111111111
11111#                             @111111111
11111# l l         |           l l @111111111
11111#             |               @111111111
11111# l l         |           l l @111111111
11111#             |               @111111111
11111# l l                     l l @111111111
11111#                             @111111111
11111# l l                     l l @111111111
11111#                             @111111111
11111# l l         |           l l @111111111
11111#             |               @111111111
11111# l l         |           l l @111111111
11111#             |               @111111111
11111# l l                     l l @111111111
11111#                             @111111111
11111# l l                     l l @111111111
11111#                             @111111111
11111# l l         |           l l @111111111
11111#             |               #11111
11111# l l         |           l l #11111
11111#             |               #11111
11111# l l                     l l #11111
11111#                             #11111
11111# l l                     l l #11111
11111#                             #11111
11111# l l         |           l l #11111
11111#             |               #11111
11111# l l                     l l #11111
11111#             |               #11111
11111#             |               #11111
11111#                             #11111
11111# l l                     l l #11111
11111# l l                     l l #11111
11111# l l                     l l #11111
11111#                             #11111
11111#             |               #11111
11111#             |               #11111
11111#                             #11111
11111# l l                     l l #11111
11111# l l                     l l #11111
11111# l l                     l l #11111
11111#                             #11111
11111#             |               #11111
11111#             |               #11111
11111#                             #11111
11111# l l                     l l #11111
11111# l l                     l l #11111
11111# l l                     l l #11111
11111#                             #11111
11111#             |               #11111
11111#             |               #11111
11111#                             #11111
11111# l l                     l l #11111
11111# l l                     l l #11111
11111# l l                     l l #11111
11111#             |               #11111
11111#             |               #11111
11111# l l                     l l #11111
11111# l l                     l l #11111
11111# l l                     l l #11111
11111#             |               #11111
11111#             |               #11111
11111# l l                     l l #11111
11111# l l                     l l #11111
11111# l l                     l l #11111
11111#             |               #11111
11111#             |               #11111
11111# l l                     l l #11111
11111# l l                     l l #11111
11111# l l                     l l #11111
11111#             |               #11111
11111#             |               #11111
11111# l l                     l l #11111
11111# l l                     l l #11111
11111# l l                     l l #11111
11111#             |               #11111
11111#             |               #11111
11111# l l                     l l #11111
11111# l l                     l l #11111
11111# l l                     l l #11111
11111#             |               #11111
11111#             |               #11111
11111# l l                     l l #11111
11111# l l                     l l #11111
11111# l l                     l l #11111
11111#             |               #11111
11111#             |               #11111
11111# l l                     l l #11111
11111# l l                     l l #11111
11111# l l                     l l #11111
11111#             |               #11111
11111#             |               #11111
11111# l l                     l l #11111
11111# l l                     l l #11111
11111# l l                     l l #11111
11111#             |               #11111
11111#             |               #11111
11111# l l                     l l #11111
11111# l l                     l l #11111
11111# l l                     l l #11111
11111#             |               #11111
11111#             |               #11111
11111# l l                     l l #11111
11111# l l                     l l #11111
11111# l l                     l l #11111
11#             |               #11111
11#             |               #11111
11# l l                     l l #11111
11# l l                     l l #11111
11# l l                     l l #11111
11#             |               #11111
11#             |               #11111
11# l l                     l l #11111
11# l l                     l l #11111
11# l l                     l l #11111
11#             |               #11111
11#             |               #11111
11# l l                     l l #11111
11# l l                     l l #11111
11# l l                     l l #11111
11#             |               #11111
11#             |               #11111
11# l l                     l l #11111
11# l l                     l l #11111
11# l l                     l l #11111
11#             |               #11111
11#             |               #11111
11# l l                     l l #11111
11# l l                     l l #11111
11# l l                     l l #11111
11#             |               #11111
11#             |               #11111
11# l l                     l l #11111
11# l l                     l l #11111
11# l l                     l l #11111
11#             |               #11111
11#             |               #11111
11# l l                     l l #11111
11# l l                     l l #11111
11# l l                     l l #11111
11#             |               #11111
11#             |               #11111
11# l l                     l l #11111
11# l l                     l l #11111
11# l l                     l l #11111
11#             |               #11111
11#             |               #11111
11# l l                     l l #11111
11# l l                     l l #11111
11# l l                     l l #11111
11#             |               #11111
11#             |               #11111
11# l l                     l l #11111
11# l l                     l l #11111
11# l l                     l l #11111
11#             |               #11111
11#             |               #11111
11# l l                     l l #11111
11# l l                     l l #11111
11# l l                     l l #11111
11#             |               #11111
11#             |               #11111
11# l l                     l l #11111
11# l l                     l l #11111
11# l l                     l l #11111
11#             |               #11111
11#             |               #11111
11# l l                     l l #11111
11# l l                     l l #11111
11# l l                     l l #11111
11#             |               #11111
11#             |               #11111
11# l l                     l l #11111
11# l l                     l l #11111
11# l l                     l l #11111
11#             |               #11111
11#             |               #11111
11# l l                     l l #11111
11# l l                     l l #11111
11# l l                     l l #11111
