11111#zlzzlzzzzzzzz|zzzzzzzzzzlzzlz#11111
11111#                             #11111
11111# l  l   e    |          l  l #11111
11111# l  l        |      e   l  l #11111
11111#                             #11111
11111#                             #11111
11111# l  l   b    |      e   l  l #11111
11111# l  l        |          l  l #11111
11111#                             #11111
11111#                             #11111
11111# l  l        |          l  l #11111
11111# l  l        |          l  l #11111
11111#                             #11111
11111#                             #11111
11111# l  l        |          l  l #11111
11111# l  l        |          l  l #11111
11111#                             #11111
11111#                             #11111
11111# l  l        |          l  l #11111
11111# l  l        |          l  l #11111
11111#                             #11111
11111#                             #11111
11111# l  l        |          l  l #11111
11111# l  l        |          l  l #11111
11111#                             #11111
11111#                             #11111
11111# l  l        |          l  l #11111
11111# l  l        |          l  l #11111
11111#                             #11111
11111#                             #11111
11111# l  l        |          l  l #11111
11111# l  l        |          l  l #11111
11111#                             #11111
11111#                             #11111
11111# l  l        |          l  l #11111
11111# l  l        |          l  l #11111
11111#                             #11111
11111#                             #11111
11111# l  l        |          l  l #11111
11111# l  l        |          l  l #11111
11111#                             #11111
11111#                             #11111
11111# l  l        |          l  l #11111
11111# l  l        |          l  l #11111
11111#                             #11111














