11##############################@11111111
11#Xl l         |           l l @11111111
11#                             @11111111
11# l l                     l l @11111111
11#                             @11111111
11# l l                     l l @11111111
11#             |               @11111111
11# l l         |           l l @11111111
11#                             @11111111
11# l l                     l l @11111111
11#                             @11111111
11# l l                     l l @11111111
11#                             @11111111
11# l l         |           l l @11111111
11#             |               @11111111
11# l l                     l l @11111111
11#                             @11111111
11# l l                     l l @11111111
11#                             @11111111
11# l l         |           l l @11111111
11#             |               @11111111
11# l l                     l l @11111111
11#                             @11111111
11# l l                     l l @11111111
11#                             @11111111
11# l l         |           l l @11111111
11#             |               @11111111
11# l l                     l l @11111111
11#                             @11111111
11# l l                     l l @11111111
11#                             @11111111
11# l l         |           l l @11111111
11#             |               @11111111
11# l l                     l l @11111111
11#                             @11111111
11# l l                     l l @11111111
11#                             @11111111
11# l l         |           l l @11111111
11#             |               @11111111
11# l l                     l l @11111111
11#                             @11111111
11# l l                     l l @11111111
11#                             @11111111
11# l l         |           l l @11111111
11#             |               @11111111
11# l l                     l l @11111111
11#                             @11111111
11# l l                     l l @11111111
11#                             @11111111
11# l l         |           l l @11111111
11#             |               @11111111
11# l l                     l l @11111111
11#                             @11111111
11# l l                     l l @11111111
11#                             @11111111
11# l l         |           l l @11111111
11#             |               @11111111
11# l l         |           l l @11111111
11#             |               @11111111
11# l l                     l l @11111111
11#                             @11111111
11# l l                     l l @11111111
11#                             @11111111
11# l l         |           l l @11111111
11#             |               @11111111
11# l l         |           l l @11111111
11#             |               @11111111
11# l l                     l l @11111111
11#                             @11111111
11# l l                     l l @11111111
11#                             @11111111
11# l l         |           l l @11111111
11#             |               @11111111
11# l l         |           l l @11111111
11#             |               @11111111
11# l l                     l l @11111111
11#                             @11111111
11# l l                     l l @11111111
11#                             @11111111
11# l l         |           l l @11111111
11#             |               @11111111
11# l l         |           l l @11111111
11#             |               @11111111
11# l l                     l l @11111111
11#                             @11111111
11# l l                     l l @11111111
11#                             @11111111
11# l l         |           l l @11111111
11#             |               @11111111
11# l l         |           l l @11111111
11#             |               @11111111
11# l l                     l l @11111111
11#                             @11111111
11# l l                     l l @11111111
11#                             @11111111
11# l l         |           l l @11111111
11#             |               #11111
11# l l         |           l l #11111
11#             |               #11111
11# l l                     l l #11111
11#                             #11111
11# l l                     l l #11111
11#                             #11111
11# l l         |           l l #11111
11#             |               #11111
11# l l                     l l #11111
11#             |               #11111
11#             |               #11111
11#                             #11111
11# l l                     l l #11111
11# l l                     l l #11111
11# l l                     l l #11111
11#                             #11111
11#             |               #11111
11#             |               #11111
11#                             #11111
11# l l                     l l #11111
11# l l                     l l #11111
11# l l                     l l #11111
11#                             #11111
11#             |               #11111
11#             |               #11111
11#                             #11111
11# l l                     l l #11111
11# l l                     l l #11111
11# l l                     l l #11111
11#                             #11111
11#             |               #11111
11#             |               #11111
11#                             #11111
11# l l                     l l #11111
11# l l                     l l #11111
11# l l                     l l #11111
11#             |               #11111
11#             |               #11111
11# l l                     l l #11111
11# l l                     l l #11111
11# l l                     l l #11111
11#             |               #11111
11#             |               #11111
11# l l                     l l #11111
11# l l                     l l #11111
11# l l                     l l #11111
11#             |               #11111
11#             |               #11111
11# l l                     l l #11111
11# l l                     l l #11111
11# l l                     l l #11111
11#             |               #11111
11#             |               #11111
11# l l                     l l #11111
11# l l                     l l #11111
11# l l                     l l #11111
11#             |               #11111
11#             |               #11111
11# l l                     l l #11111
11# l l                     l l #11111
11# l l                     l l #11111
11#             |               #11111
11#             |               #11111
11# l l                     l l #11111
11# l l                     l l #11111
11# l l                     l l #11111
11#             |               #11111
11#             |               #11111
11# l l                     l l #11111
11# l l                     l l #11111
11# l l                     l l #11111
11#             |               #11111
11#             |               #11111
11# l l                     l l #11111
11# l l                     l l #11111
11# l l                     l l #11111
11#             |               #11111
11#             |               #11111
11# l l                     l l #11111
11# l l                     l l #11111
11# l l                     l l #11111
11#             |               #11111
11#             |               #11111
11# l l                     l l #11111
11# l l                     l l #11111
11# l l                     l l #11111
11#             |               #11111
11#             |               #11111
11# l l                     l l #11111
11# l l                     l l #11111
11# l l                     l l #11111
11#             |               #11111
11#             |               #11111
11# l l                     l l #11111
11# l l                     l l #11111
11# l l                     l l #11111
11#             |               #11111
11#             |               #11111
11# l l                     l l #11111
11# l l                     l l #11111
11# l l                     l l #11111
11#             |               #11111
11#             |               #11111
11# l l                     l l #11111
11# l l                     l l #11111
11# l l                     l l #11111
11#             |               #11111
11#             |               #11111
11# l l                     l l #11111
11# l l                     l l #11111
11# l l                     l l #11111
11#             |               #11111
11#             |               #11111
11# l l                     l l #11111
11# l l                     l l #11111
11# l l                     l l #11111
11#             |               #11111
11#             |               #11111
11# l l                     l l #11111
11# l l                     l l #11111
11# l l                     l l #11111
11#             |               #11111
11#             |               #11111
11# l l                     l l #11111
11# l l                     l l #11111
11# l l                     l l #11111
11#             |               #11111
11#             |               #11111
11# l l                     l l #11111
11# l l                     l l #11111
11# l l                     l l #11111
11#             |               #11111
11#             |               #11111
11# l l                     l l #11111
11# l l                     l l #11111
11# l l                     l l #11111
11#             |               #11111
11#             |               #11111
11# l l                     l l #11111
11# l l                     l l #11111
11# l l                     l l #11111
11#             |               #11111
11#             |               #11111
11# l l                     l l #11111
11# l l                     l l #11111
11# l l                     l l #11111
11#             |               #11111
11#             |               #11111
11# l l                     l l #11111
11# l l                     l l #11111
11# l l                     l l #11111
11#             |               #11111
11#             |               #11111
11# l l                     l l #11111
11# l l                     l l #11111
11# l l                     l l #11111
11#             |               #11111
11#             |               #11111
11# l l                     l l #11111
11# l l                     l l #11111
11# l l                     l l #11111
