1111#zzzz|zzzz|zzzz|zzzz|zzzz|zzzz#11111
1111#                             #11111
1111#    |    |    |    |    |    #11111
1111#    |    |    |    |    |    #11111
1111#                             #11111
1111#                             #11111
1111#    |    |    |    |    |    #11111
1111#    |    |    |    |    |    #11111
1111#                             #11111
1111#                             #11111
1111#    |    |    |    |    |    #11111
1111#    |    |    |    |    |    #11111
1111#                             #11111
1111#                             #11111
1111#    |    |    |    |    |    #11111
1111#    |    |    |    |    |    #11111
1111#                             #11111
1111#                             #11111
1111#    |    |    |    |    |    #11111
1111#    |    |    |    |    |    #11111
1111#                             #11111
1111#                             #11111
1111#    |    |    |    |    |    #11111
1111#    |    |    |    |    |    #11111
1111#                             #11111
1111#    |    |    |    |    |    #11111
1111#    |    |    |    |    |    #11111
1111#                             #11111
1111#    |    |    |    |    |    #11111
1111#    |    |    |    |    |    #11111
1111#                             #11111
1111#    |    |    |    |    |    #11111
1111#    |    |    |    |    |    #11111
1111#                             #11111
1111#    |    |    |    |    |    #11111
1111#    |    |    |    |    |    #11111
1111#                             #11111
1111#    |    |    |    |    |    #11111
1111#    |    |    |    |    |    #11111
1111#                             #11111













1111#|    | ee |    |    |    |    |    #
    #   |    | ee |    |    |    |    |    #
    #                                      #
    #   |    |    |    |    |    |    |    #
    #   |    | e  |    |    |    |    |    #
#                                      #
#   |    |    |    |    |    |    |    #
#   |    |    |    |    |    |    |    #
#        |          |         |        #
#                         b            #
#        |          |         |        #
#        |          |         |        #
#                                      #
#        |          |         |        #
#       e|          |         |        #
#                                      #
#        |          |   b     |        #
#        |          |         |       e#
#                                     e#
#        |          |         |       e#
#        |          |         |       e#
#                                      #
#        |          |         |       e#
#        |          |         |        #
#                                      #
#                   |                  #


